8 18
||||||||||||||||||
|...||....@.....||
|..F...||...|...||
|.|....||........|
|..|.....*...|...|
|.......||..F..|.|
|....|...........|
||||||||||||||||||