10 20
|------------------|
|...|..-.|.........|
|..-|.....@.....|..|
|..F...--...|...|..|
|--....||..........|
|..|.....*...|.....|
|..|......---.F....|
|......--......|...|
|....|.........|...|
|------------------|